7,7
5,1
1,5
XXXXXXX
X00000X
X0XXXXX
X00000X
XXXXX0X
X00000X
XXXXXXX
