7,7
1,5
5,1
XXXXXXX
X00000X
X0XXXXX
X00000X
XXXXX0X
X00000X
XXXXXXX
