9,5
4,0
0,4
XXXX0XXXX
XX00000XX
XX0X0X0XX
000X0X000
0X0X0X0X0
