7,7
1,1
5,5
XXXXXXX
X0X000X
X0X0X0X
X0X0X0X
X0X0X0X
X000X0X
XXXXXXX
